O O O O O R O O O O R O O O O O O R O O O
O O O O O O C C C C C C C O O H H O O O O
R O O O O O C C C C C C C O O H H O O O O
O O R O O O C C C C C C C O O O O O R O O
O O O O R O O O O O O O O O O O O O O O O
O O O O O O O O O O O O O O O O O O O O O
R R O O O O O O O O T T O O O O O O O O O
O O C C C C C C C O T T O O O O O O O O O
O O C C C C C C C O O O O O O R R R R R O
O O C C C C C C C O O O O O O O O O O O O
O O O O O R R O O O O O O O O O O O R R O
O R O O O O O O O O O O O O O O O O O R O
O O O O O O O O O O R O O O R O O O O O O
O O O O O O O O O O O O O O O O O O O O O